KC코트렐 - 태양광발전사업
에코바이오 - 매립지가스정제후 수소생산
한솔홈데코 - 종합건축자재생산업체
씨에스윈드 - 풍력발전 관련 컨설티
에코프로 - 환경사업
후성 - 가스제조 
OCI - 케미컬사업
삼성엔지니어링 - 환경부문 신재생성장포인트보유
롯데케미칼 - 석유화학전문기업 탄소중립성장
한솔홀딩스 - 한솔그룹지주사 뉴질랜드숲조성사업
이건홀딩스 - 신재생에너지이건에너지 거느림 
이건산업 - 이건그룹핵심계열사 온실가스감축사업참여
KC그린홀딩스 - 녹색사업전문그룹도모 
에코프로에이치엔 - 에코프로에서 인적분할된 사후처리전문기업
휴켐스 - 정밀화학핵심소재전문기업
후성 - 불소기반 화합물제조공급판매 온실가스감축하는저감시설보유
세종공업 - 배기가스저감기술 등 일산화탄소제거기취급
LX인터내셔널 - 팜오일생산 탄소배출권내다파는사업
태경비케이 - 화암광산에서 채광기술 현대화실현 환경오염방지사업
그린케미칼 - KPX케이칼로부터 물적분할한 친환경기능성정밀화학제품제조기업
켐트로스 - 첨단소재융합소재 사업 전문업체 
클라우드에어(라이브파이낸셜) - 핀테크계기판바이오사업협력관계
경남제약 - 바이오제약전문기업 이산화탄소이용
SGC에너지(SGCENERGY) - 열병합발전방식사용
글로벌에스엠(Global SM Tech) - 건설관리전문회사 에코누리시스템도입
그린플러스(GREEN) - 첨단온실전문기업 식물공장사업영위
한미글로벌(HanmiGlobal) - 건설사업관리전문회사 환경컨설팅운영
에스코넥(S-connect) - 갤럭시부품취급 태양열에너지활용
지엔씨에너지(ENERGY-GENERATE GREEN TECHNOLOGY) - 비상발전문기 전문업체 
지엔원에너지(G-ENONE ENERGY) - 신재생에너지전문기업
삼영에스엔씨 - 센서개발기업 환경센서전문업체
유니드 - 칼륨계화학제품전문업체 신재생에너지확대

태양광부문
한화 - 한화우 - 한화솔루션 - 한화솔루션우 - LG - LG우 - LG전자 - LG전자우 - 
LG화학 - LG화학우 - 삼성물산 - 삼성물산우B - 삼성SDI - 삼성SDI우 - SK - SK우 - 
SK이노베이션 - SK이노베이션우 - SK머티리얼즈 - SK머티리얼즈우 - SK디앤디 - SKC
 - 국영지앤엠 - 유니테스트 - 효성 - 효성중공업 - 현대중공업지주 - 한국조선해양 - 
현대에너지솔루션 - 현대일렉트릭 - 에스에너지 - 코오롱글로벌 - 코오롱글로벌우 - 
한미반도체 - 윌링스 - SDN - 아바코 - 신성이엔지 - OCI - KCC - LS - LS ELECTRIC -
LS전선아시아 - 이건홀딩스 - 주성엔지니어링 - 도화엔지니어링 - 한솔테크닉스 - 뉴인텍 - 
광명전기 - 파루 - 혜인 - 테스(TES) - 티씨케이 - 원익IPS - 에스에프씨 - 비디아이 - 삼지전자 
- 에스폴리텍 - 엘오티베큠 - 대성파인텍 - 인트로메딕 - 한전산업 - 한전기술 - 한전KPS - 
한국전력 - 레이크머티리얼즈 - 에스엔유 - 파워넷 - 코센 - 에이프로 - 에스와이 - 파워로직스 -
 피앤씨테크 - HDC아이콘트롤스 - 그린플러스 - 대한그린파워 - 디에스케이 - 엘아이에스 -
 엔시스 - 이삭엔지니어링

풍력부문 
한화 - 한화우 - 한화솔루션 - 한화솔루션우 - LG - LG우 - LG전자 - LG전자우 -
 LG화학 - LG화학우 - 삼성SDI - 삼성SDI우 - SK이노베이션 - SK이노베이션우 - 
SK디앤디 - 현대차 - 현대차우 - 현대차2우B - 현대차3우B - 현대제철 - 대창솔루션
 - 화천기계 - 화천기공 - 씨에스윈드 - 씨에스베어링 - 유니슨 - 동국산업 - 동국S&amp;C 
- 포메탈 - 태웅 - THE E&amp;M - DMS - STX - STX중공업 - STX엔진 - 효성 - 효성중공업 
- 삼강엠앤티 - 삼영엠텍 - 케이피에프 - 두산 - 두산우 - 두산2우B - 두산중공업 - 우림피티에스 
- 스페코 - 한일단조 - 코오롱글로벌 - 코오롱글로벌우 - 한전산업 - 한전기술 - 한전KPS - 한국전력
 - 우리기술 - LS - LS ELECTRIC - LS전선아시아 - 대한전선 - 서암기계공업 - KT서브마린 - 비디아이
 - 세진중공업 - 한국조선해양 - 피앤씨테크 - 대한그린파워 - 삼일씨엔에스 - 세아제강지주 - 세아제강
 - 이삭엔지니어링 - 해성티피씨 - 현진소재 - 코센

곡물/밀가루/제분/계란/식품 원료/식량/식품/사료 애그플레이션 부문
CJ - CJ우 - CJ제일제당 - CJ제일제당우 - CJ씨푸드 - CJ씨푸드1우 - 
CJ프레쉬웨이 - CJ ENM - 오뚜기 - 롯데지주 - 롯데지주우 - 롯데푸드 - 
롯데칠성 - 롯데칠성우 - 롯데제과 - 롯데쇼핑 - 롯데하이마트 - 현대백화점 - 
현대홈쇼핑 - 현대그린푸드 - SK - SK우 - SK텔레콤 - 빙그레 - 크라운해태홀딩스 -
 해태제과식품 - 신세계 - 신세계푸드 - 호텔신라 - 호텔신라우 - 광주신세계 - 이마트
 - GS - GS우 - GS리테일 - GS홈쇼핑 - 한화 - 한화우 - 한화솔루션 - 한화솔루션우 - 
BGF - BGF리테일 - 대구백화점 - 베뉴지 - 인터파크 - 세이브존i&amp;C - 다나와 - 동원산업
 - 동원수산 - 동원F&amp;B - 동원시스템즈 - 동원시스템즈우 - 서울식품 - 서울식품우 - 매일유업
 - 남양유업 - 남양유업우 - SPC삼립 - 농심홀딩스 - 농심 - 율촌화학 - 삼양식품 - 샘표 - 샘표식품
 - 풀무원 - 하림지주 - 하림 - 엔에스쇼핑 - 선진 - 팜스코 - 이지홀딩스 - 이지바이오 - 마니커 -
 마니커에프엔지 - 팜스토리 - 정다운 - 동우팜투테이블 - 체리부로 - 푸드나무 - 해마로푸드서비스
 - 교촌에프앤비 - 사조산업 - 사조오양 - 사조대림 - 사조씨푸드 - 사조동아원 - 한성기업 -  신라교역
 - 신라에스지 - 한창 - 대한제분 - 삼양사 - 삼양사우 - 한탑 - 신송홀딩스 - 푸드웰 - 대상홀딩스 -
 대상홀딩스우 - 대상 - 대상우 - 보라티알 - 우리손에프앤지 - 윙입푸드 - 디딤 - 우양 - 바른손 - 
바른손이앤에이 - 판타지오 - 웰바이오텍 - 한국가구 - 한국맥널티 - 흥국에프엔비 - 케이씨피드 - 
지어소프트 - 오아시스 - 엠에스씨 - 에스앤디 - 엔시트론 - NAVER(네이버) - 카카오(KAKAO) - SK케미칼
 - SK케미칼우 - SK이노베이션 - SK이노베이션우 - SKC - 효성티앤씨 - LG화학 - LG화학우 - 한화솔루션
 - 롯데정밀화학 - 롯데케미칼 - 그린케미칼 - 삼양패키징 - 휴비스 - 한국팩키지 - 삼영화학 - 삼륭물산 
- 세하 - 오공 - 금비 - 삼화왕관 - SGC에너지

비료/농업/농약/종자/종묘 부문
이지홀딩스 - 이지바이오 - 조비 - 경농 - 팜스토리 - 농우바이오 - 효성오앤비 
- 남해화학 - 카프로 - KG케미칼 - 동방아그로 - 태경케미컬 - 태원물산 - 체시스 
- 우리손에프앤지 - 엠에스씨 - 성보화학 - 롯데정밀화학 - KPX생명과학 - 인바이오
 - 대유 - 우성사료 - 아시아종묘

동물 사료/사료 부문
우성사료 - 한일사료 - 현대사료 - 하림지주 - 하림 - 팜스코 - 팜스토리
 - 선진 - 미래생명자원 - CJ제일제당 - 이지홀딩스 - 이지바이오 - 한탑 -
 대주산업 - 케이씨피드 - 고려산업 - 우진비앤지 - 이글벳 - 대한제당 - 
사조동아원 - 씨티씨바이오 - 대상홀딩스 - 카프로

농기계 부문
두산중공업 - 두산인프라코어 - 두산밥캣 - 동양물산 - 포메탈 - 골든센츄리 -
 디젠스 - 청보산업 - 아세아텍 - 대동공업 - 대동기어 - 대동금속 - 아이쓰리시스템

수산/수산물 부문
사조산업 - 사조오양 - 사조대림 - 사조씨푸드 - 사조동아원 - 동원산업 - 동원수산 
- 동원F&amp;B - 한성기업 - 신라교역 - 신라에스지 - CJ제일제당 - CJ씨푸드 - CJ씨푸드1우 - 오뚜기 - 한창